NO ./textures/north.xpm
EA ./textures/east.xpm
SO ./textures/south.xpm
WE ./textures/south.xpm

F 220,100,0
C 10,220,0

1111111111111111111
1000000000000000001
1000000000000000001
1000000000000000001
1000000000000000001
1000000000000000001
1000000000000011111
1111110000000011111
1111110000000011111
1111110000000000001
100000000000000E001
1111111111111111111