NO ./textures/north.xpm
EA ./textures/east.xpm
SO ./textures/south.xpm
WE ./textures/west.xpm

F 220,100,0
C 225,30,0

1111111111111111111
1000000000000000001
1000000000000000001
1000000000000000001
1000000000000000001
1000000000000000001
1000000000000000001
1000000000000000001
1000000000N00000001
1000000000000000001
1000000000000000001
1000000000000010001
1000000000000011111
1111110000000011111
1111110000000011111
1111110000000000001
1000000000000000001
1000000000000000011
1111111111111111111