NO ./textures/north.xpm
SO ./textures/south.xpm
WE ./textures/west.xpm
EA ./textures/east.xpm

F 220,100,0
C 225,30,0

1111111111111111111
1000000000000000001
1000000000000000001
1000000000000000001
1000001111100000001
1000001111100000001
1000001111100000001
1000000000000000001
1000000000000000001
100000000N000000001
1000000000000000001
1000000000000000001
1000000000000011111
1111110000000011111
1111110000000011111
1111110000000000001
1000000000000000001
1000000000000000001
1111111111111111111