NO ./path_to_the_north_texture
SO ./path_to_the_south_texture
WE ./path_to_the_west_texture
EA ./path_to_the_east_texture

F 220,100,0
C 225,30,0

111     1111111111111111111111111
101     1000000000110000000000001
111     1011000001110000000000001
        1001000000000000000000001
111111111011000001110000000000001
10000000001100000111011111111111111
11110111111111011100000010001111100000001
1111011     11111110111000000100011111111
111101111111110111010100100011111
11000000110101011100000010001111
10000000000000000000000000010001
10000000000000001101010010001111
1100000111010101111101111000111
11110111 1110101   101111010001
11111111 1111111   111111111111
