NO ./path_to_the_north_texture
SO ./path_to_the_south_texture
WE ./path_to_the_west_texture
EA ./path_to_the_east_texture

F 220,100,0
C 225,30,0

        111111111111111111111111111
        100000000011000000000000001
        101100000111000000000000111
        100100000000000000000000N1
1111111110110000011100000000000011
10000000001100000111011111111111111111111
11110111111111011100000010001111000000001
1111011     11111110111000000000011111111
111101111111110111010100100011111
1100000011010101110000001000111101
100000000000000000000000000000011
100000000000000011010100100011111111111111111111111111111111111111111111111111
111111111111111111111111111111111111111
1   1       1 1     1    1 111 
11110111 1110101   101111010001111111111111111111111111111111111111111111
11111111 1111111   111111111111111
11111111111111111111111111111111111111111111111111111111111111111111111111111111111