NO ./textures/north.xpm
EA ./textures/east.xpm
SO ./textures/south.xpm
WE ./textures/west.xpm

F 220,100,0
C 0,120,170

1111111111111111111
1000000000000000001
1000000000000000001
1000000000000000001
1000000000000000001
1000000000000000001
1000000000000011111
1111111111011111111
111111000000001111
11111000N000000001
100000000000011001
1111111111111111111