NO ./textures/north.xpm
EA ./textures/east.xpm
SO ./textures/sassocarta.xpm
WE ./textures/sassocarta.xpm

F 220,100,0
C 10,220,0

1111111111111111111                                                       11111
1000000000000000001           111111111111111111111111111111111111111111111
1000000000000000001                         11111
1000000000000000001                                   11111
10000000000000000011111111111111111111111111111111111111111111111111
1000000000000000001111111111111111111111111111111111           11111111111111
1000000000000011111                            111111111111111111
1111110000000011111111111111111111111111111111111111111
1111110000000011111                    11111111111111111
1111110000000000001                                     11111111111111111  11
100000000000000E001                                      111
11111111011111111111111111111111111111111111111111111111111111111
11111111111111111111111111111111111111111111