NO ./textures/north.xpm
EA ./textures/east.xpm
SO ./textures/south.xpm
WE ./textures/west.xpm

F 255,255,255
C 0,0,0

 111111111
 111000001
1W0001111
10011
 1111111