NO ./textures/sassocarta.xpm
EA ./textures/sassocarta.xpm
SO ./textures/sassocarta.xpm
WE ./textures/sassocarta.xpm

F 36,28,24
C 71,57,47

1111111111111111111
1000000000000000001
1000000000000000001
100000000F000000001
1000000000000000001
1000000000000000001
1000000000000011111
111111111D111111111
11111100000000D1111
11111D000N0C0000001
10000000000001D1001
1111111111111111111