NO ./textures/north.xpm
EA ./textures/east.xpm
SO ./textures/sassocarta.xpm
WE ./textures/sassocarta.xpm

F 220,100,0
C 10,220,0

1111111111111111111
1000000000000000001
1000000000000000001
10000000000000D0001
1000000000000000001
1000000000000000001
1000000000000011111
1111110000000011111
11111100000000D1111
11111100000000N0001
1000000000000000001
1111111111111111111