NO ./textures/sassocarta.xpm
EA ./textures/sassocarta.xpm
SO ./textures/sassocarta.xpm
WE ./textures/sassocarta.xpm

F 36,28,24
C 25,100,100

1111111111111111111
10000000000F0000001
10000F00000000000F1
1000000000000000011
1000000000000000001
100F000000000000001
1000000000000N11F11
111111111D111111111
11111100000000D1111
11111D00000C0000001
10000000000001D1001
1111111111111111111